NO ./textures/ancientstone.xpm

SO ./textures/bluestone.xpm
WE    ./textures/brick.xpm
EA ./textures/wallhole.xpm
F   220,100,0
C  225,30,0




1111111111111111111111111111111
1000001100000000000000011100001
1000110000000000000000000111001
101100000000000000000000001111
1110000000000000000000000000001
1000000000000111110000000000001
1000000000000011100000000000001
1000000000000001000000000000001
1000000000000000000000000000001
100000000000000N000000000000001
1000000000000000000000000000001
1000000000000000000000000000001
1111111111111111111111111111111