        NO                       textures/mbd.xpm
SO textures/wood.xpm
WE textures/rwd.xpm
EA textures/rwl.xpm

    F    220,      100          ,0
C 225,30,0


111111111111111111111
100000000010000000001
101010101010101010101
1000000000S0000000001
101010101010101010101
100000000010000000001
111111111111111111111


C 225,30,0
