        NO                       textures/mbd.xpm
SO textures/wood.xpm
WE textures/rwd.xpm
EA hello.xpm

    F    0,      0         ,354
C 225,30,0


        1111111111111111111111111
        1000000000110000000000001
        1011000001110000000000001
        1001000000000000000000001
111111111011000001100000000000001
10000000011000001110111111111111
11110111111111011100000010001
1111011111111011101010010001
11000000110101011100000010001
11110111000000001100000000001
100000010000000011010100N0001
100000011101010111110111000111
11110111 1110101 101111010001
11111111 1111111 111111111111


C 225,30,0
