NO ./textures/ancientstone.xpm

SO ./textures/bluestone.xpm
WE    ./textures/brick.xpm
EA ./textures/wallhole.xpm
   F   220,100,0
C  225,30,0


   F   120,89,0

11111111111111111111111111111111
1                              1
1      1  00 00 0110000000000001
1      1011000001110000000000001
1      1001000000000000000000001
1      1111111110110000011100001
1 111111111001100000111010001111
111110111111111011100000111111
11110111111111011101010010011
11000000110101011100000010001
1000 00000000000000000100011
100000000000000011010100100011
11000001110101011111011110N0001
 111111 1111111 11111111111111

11111111 1111111 1111111111111
